107
10
22 4 0 0 0 0 0 0 0 0 0 0 0 0 0 0 0 0 0 0 0 3 22 22 22 22 22 22 22 22 22 22 22 22 22 22 4 0 0 0 0 0 0 0 0 0 0 0 0 0 0 0 0 0 0 0 0 0 0 0 0 0 0 0 0 0 0 0 0 0 0 0 0 0 0 0 0 0 0 0 0 0 3 22 22 22 22 22 22 22 22 22 22 22 22 22 22 22 22 22 22 22 22 22 22 22 22
22 4 0 0 0 0 0 0 0 0 0 0 0 0 0 0 0 0 0 0 0 3 22 22 22 22 22 22 22 22 22 22 22 22 22 19 0 0 0 0 0 0 0 0 0 0 0 0 0 0 0 0 0 0 0 0 0 0 0 0 0 0 0 0 0 0 0 0 0 0 0 0 0 0 0 0 0 0 0 0 0 0 0 17 18 22 22 22 22 22 22 22 22 22 22 22 22 22 22 19 17 18 22 22 22 22 22
22 4 0 0 0 0 0 0 0 0 0 0 0 0 0 0 0 0 0 0 0 3 22 22 22 22 22 22 22 22 22 22 22 22 19 0 0 0 0 0 0 0 0 0 0 0 0 0 0 0 0 0 0 0 0 0 0 0 0 0 0 0 0 0 0 0 0 0 0 0 0 0 0 0 0 0 0 0 0 0 0 0 0 0 0 18 22 22 22 22 22 22 22 22 22 22 22 19 17 0 0 0 18 22 22 22 22
22 4 0 0 0 0 0 0 0 0 0 14 0 0 0 0 0 0 0 0 0 0 18 22 22 22 22 22 22 22 22 22 22 22 4 0 0 0 0 0 0 0 0 0 0 0 0 0 0 0 0 0 0 0 14 0 0 0 0 0 0 0 0 0 0 0 0 0 0 0 0 0 0 0 0 0 0 0 0 0 0 0 0 0 0 0 18 22 22 22 22 22 22 22 22 19 17 0 0 0 0 0 0 18 22 22 22
22 4 0 0 0 0 0 0 0 0 10 0 0 0 0 0 0 0 11 9 0 0 3 22 22 22 22 22 22 22 22 22 22 22 4 0 0 0 0 0 10 0 0 1 21 21 2 0 0 0 0 0 0 0 0 0 0 0 10 0 9 0 0 0 0 0 0 0 0 0 0 0 0 0 0 0 0 0 0 0 0 0 0 0 0 0 3 22 22 22 22 22 22 22 19 0 0 0 0 0 0 0 0 0 18 22 22
22 4 0 0 0 0 0 0 13 0 23 24 25 0 0 0 0 23 24 25 0 0 0 17 18 22 22 22 22 22 22 22 22 19 0 0 0 0 23 24 25 0 0 3 22 22 4 9 10 1 21 21 2 0 0 0 0 1 21 21 21 2 0 0 0 0 0 11 0 0 0 0 0 0 0 0 0 0 0 0 0 0 0 0 0 0 0 18 22 22 22 22 22 19 0 0 0 0 0 0 0 0 0 0 0 18 22
22 4 0 12 0 0 0 0 0 9 0 0 0 0 0 0 0 0 0 0 0 0 11 0 0 17 17 17 17 17 17 17 17 0 0 0 0 0 0 0 0 0 11 3 22 5 21 21 21 21 6 22 4 0 0 0 0 3 22 22 22 4 11 0 10 1 21 21 2 0 0 0 0 0 0 0 0 0 0 0 0 0 0 0 0 0 0 0 18 22 22 19 17 0 0 0 0 0 0 0 0 0 0 0 0 3 22
22 4 0 0 0 0 1 21 21 21 2 0 0 0 0 0 0 0 0 1 21 21 21 2 0 16 0 0 0 0 0 0 0 0 0 11 0 0 0 0 0 1 21 21 6 22 22 22 22 22 22 22 4 0 0 0 0 3 22 22 5 21 21 21 21 21 6 22 4 0 9 11 1 21 21 2 0 0 0 0 0 0 0 0 0 0 9 0 0 17 17 0 0 0 0 0 0 0 0 0 0 0 0 0 0 3 22
22 4 0 11 0 10 3 22 22 22 4 0 0 0 0 0 0 0 0 3 22 22 22 4 11 0 10 1 21 21 2 10 0 9 1 21 21 2 9 0 0 3 22 22 22 22 22 22 22 22 22 22 4 0 0 0 0 3 22 22 22 22 22 22 22 22 22 5 21 21 21 21 21 6 22 4 0 10 0 11 0 0 0 0 1 21 21 2 0 11 0 10 0 0 0 9 0 0 0 10 11 0 0 9 0 3 22
5 21 21 21 21 21 21 6 22 22 4 0 0 0 0 0 0 0 0 3 22 22 5 21 21 21 21 21 6 5 21 21 21 21 21 6 5 21 21 21 21 21 6 22 22 22 22 22 22 22 22 22 4 0 0 0 0 3 22 22 22 22 22 22 22 22 22 22 22 22 22 22 22 22 5 21 21 21 21 21 21 21 21 21 21 6 5 21 21 21 21 21 21 21 21 21 21 21 21 21 21 21 21 21 21 21 6
